
############################################################
#..........................................................#
#..P.......................................................#
#..............####.............####.............####......#
#..............#..#.............#..#.............#..#......#
#..............####.............####.............####......#
#..........................................................#
#.....######................##########.....................#
#.....#....#................#........#.....................#
#.....######................##########.....................#
#..........................................................#
#........####....####....####....####....####....####......#
#........#..#....#..#....#..#....#..#....#..#....#..#......#
#........####....####....####....####....####....####......#
#..........................................................#
#..####..............####..............####...........####.#
#..#..#..............#..#..............#..#...........#..#.#
#..####..............####..............####...........####.#
#..........................................................#
#......########..................########..................#
#......#......#..................#......#..................#
#......########..................########..................#
#..........................................................#
#....####....####....####....####....####....####....####..#
#....#..#....#..#....#..#....#..#....#..#....#..#....#..#..#
#....####....####....####....####....####....####....####..#
#..........................................................#
#....................##############........................#
#....................#............#........................#
#....................##############........................#
#..........................................................#
############################################################





