########################################
#......................................#
#..........#.................#.........#
#..........#.................#.........#
#..........#.................#.........#
#..........#.................#.........#
#..........#.......#####.....#.........#
#..........#..................#........#
#..........#..........#####...#........#
#..........#..................#........#
#.....P....#.......#####......#........#
#..........#..................#........#
#..........#.....#####........#........#
#..........#..................#........#
#..........#..............#####........#
#..........#...........................#
#..........##########..............#####
#......................................#
########################################
